%%%%%%%%%%%%%%%%%%%%
%o...%........%...o%
%.%%.%.%%..%%.%.%%.%
%....... P  %......%
%.%.%%.%    %.%%.%.%
%.%....% o  %.%..%.%
%.%.%%.% %% %.%.%%.%
%.%................%
%.%%.%.%%..%%.%.%%.%
%o..G%........%G..o%
%%%%%%%%%%%%%%%%%%%%