%%%%%%%%%%%%%%%%%%%%%%
%                    %
% %%%%%%%%  %%%%%%%% %
%                    %
% % %%%%%%%%%%%%%% % %
% G     .   .      % %
% %%%%%%%G G%%%%%%%% %
%                 .% %
% %%%%%%%% %%%%%%%%% %
%P                   %
%%%%%%%%%%%%%%%%%%%%%%