%%%%%%%%%%%%%%%%%%%%%%
%P                   %
% %%%%%%%%  %%%%%%%% %
%                    %
% % %%%%%%%%%%%%%% % %
% G     .   .      % %
% %%%%%%%G G%%%%%%%% %
%                 .% %
% %%%%%%%% %%%%%%%%% %
%                    %
%%%%%%%%%%%%%%%%%%%%%%