%%%%%%%%%%%%%%%%%%%%%%
%                    %
% %%%%%%%%  %%%%%%%% %
%                    %
% % %%%%%%%%%%%%%% % %
% G     .   .      % %
% %%%%%%%G G%%%%%%%% %
% P               .% %
% %%%%%%%% %%%%%%%%% %
%                    %
%%%%%%%%%%%%%%%%%%%%%%