%%%%%%%%%%%%%%%%%
%              .%
%%%%%%%%%% %GGG%%
%.              %
%%GG%P%%%%%%%%G%%
%              .%
%%%%%%%%%%%%%%%%%