%%%%%%%%%%%%%%%
%            .%
% G% %G% %GGG %
% %   % P %%% %
% % % % % %   %
%   %   %   %.%
%%%%%%%%%%%%%%%