%%%%%%%%%%%%%%%
%.     P     .%
%%%%G        G%
%.            %
%%%%G        %%
%.           .%
%%%%%%%%%%%%%%%