%%%%%%%%%%%%%%%%%%%%%%%%%%%%%%
%P                          .%
%%%%%%%%%%%%%%%%%%%%%% %GGGG%%
%.                           %
%%GGG% %%%%%%%%%%%%%%%%%%%%%%%
%                           .%
%%%%%%%%%%%%%%%%%%%%%%%% %GG%%
%.                           %
%%G% %%%%%%%%%%%%%%%%%%%%%%%%%
%                            %
%%%%%%%%%%%%%%%%%%%%%%%%%%%% %
%                            %
% %%%%%%%%%%%%%%%%%%%%%%%%%%%%
%                           .%
%%%%%%%%%%%%%%%%%%%%%%%%%%%%%%