%%%%%%%%%%%%%%%%%%%%%%%%%%%%%%
%                            %
% %%%%%%%%%%% %%%%%%%%% %%%% %
% %        %   %           % %
% % %%%% %G% % G  %%%%%%%%%% %
% % %.       % G          .% %
% % %%%%%%%% %.%.    %%%%% % %
% %           %%%GG      % % %
% %%%%%%%% %% %%.%% %%%% % % %
% %         G %G %       G % %
% % %%%%%%%%% %G % %%%%%%% % %
% %              %       % % %
% % %%%% %%%% %%%%%%%%%% % % %
%                           P%
%%%%%%%%%%%%%%%%%%%%%%%%%%%%%%