%%%%%%%%%%%%%%%%%%%%%%
%P                   %
% %%%%%%%%%%%%%%%%%% %
%                  % %
% %%%%%%%%%%%%%%%% % %
% G         .      % %
% %%%%%%%G G%%%%%%%% %
%                 .% %
% %%%%%%%%%%%%%%%%%% %
%                    %
%%%%%%%%%%%%%%%%%%%%%%