%%%%%%%%%%%%%%%%%%%%%%
%                    %
% %%%%%%%%%%%%%%%%%% %
%                  % %
% %%%%%%%%%%%%%%%% % %
% G         .      % %
% %%%%%%%G G%%%%%%%% %
% P               .% %
% %%%%%%%%%%%%%%%%%% %
%                    %
%%%%%%%%%%%%%%%%%%%%%%