%%%%%%%%%%%%%%%%%
%              .%
% %%%%%%%%% %GG%%
% %%.          .%
% %G%%%%%%%%%GG %
%P              %
%%%%%%%%%%%%%%%%%