%%%%%%%%%%%%%%%%%
%              .%
%%%%%%%%%% %GGG%%
%.              %
%%GG% %%%%%%%%G%%
%P             .%
%%%%%%%%%%%%%%%%%